...............................
...................########....
.....#####.....................
#.....................#####...#
#...........######............#
#.............................#
###############################